##########\n
#________#\n
#S>>v____#\n
#___v____#\n
#___>>v__#\n
#_____v__#\n
#_____>v_#\n
#______v_#\n
#____X<<_#\n
##########\n
