#############\n
#_S_________#\n
#_v_________#\n
#_>>>v______#\n
#____v______#\n
#____>>>>>v_#\n
#_________v_#\n
#_________v_#\n
#__X<<<<<<<_#\n
#############\n
