##########\n
#__S_____#\n
#__v__X__#\n
#__v__^__#\n
#__v__^__#\n
#__v__^__#\n
#__v__^__#\n
#__>>>^__#\n
#________#\n
##########\n
