#############\n
#S>>>>>v____#\n
#______v____#\n
#___________#\n
#_______>>v_#\n
#_________v_#\n
#_________v_#\n
#_________v_#\n
#__X<<<<<<<_#\n
#############\n
