#################\n
#_______________#\n
#_S>>v______X___#\n
#____v______^___#\n
#____v______^___#\n
#____v______^___#\n
#____v______^___#\n
#____v______^___#\n
#____>>>>>>>^___#\n
#################\n
